w	w	w	w	w	w	w	w	w	w	w	w	w	w	w	w
w	sh	b	b	sh	sh	sh	sh	b	b	sh	sh	b	b	b	b
w	b	sh	sh	b	sh	sh	b	sh	sh	b	sh	sh	sh	sh	b
w	sh	sh	sh	b	sh	sh	sh	sh	sh	b	sh	sh	sh	b	w
w	sh	sh	b	sh	sh	sh	sh	sh	b	sh	sh	sh	sh	b	w
w	sh	b	sh	sh	sh	sh	sh	b	sh	sh	sh	sh	b	sh	w
w	b	sh	sh	sh	sh	sh	b	sh	sh	sh	sh	sh	b	sh	w
w	b	b	b	b	sh	sh	b	b	b	b	sh	sh	b	sh	w
w	0	0	0	0	0	0	0	0	0	0	0	0	0	0	w
