0	0	0	0	0	0	0	0	0	0	0	0	0	0	0	0
0	0	0	0	0	0	i	0	i	0	i	0	i	0	0	0
0	0	0	0	0	i	i	i	i	0	0	0	0	0	i	i
0	0	0	0	i	0	i	0	0	0	0	0	i	0	0	0
0	0	0	i	0	i	i	i	0	i	0	i	0	i	0	0
0	0	0	0	0	0	0	0	0	0	0	0	0	0	0	i
0	0	0	0	0	0	0	0	0	0	0	0	0	0	0	0
0	0	0	0	i	0	0	0	i	0	i	0	0	i	0	0
0	0	0	0	0	0	0	0	0	0	0	0	0	0	0	0
